XXXXXXXXXXXXXXXXXXXXXXXXXXXXXXXXXXXXXXXXXXXXXXXXXXXXXXXXXXXX
X                                                          X
X   A                                                      X
X                                                          X
X                                                          X
X                                                          X
X                                                          X
X                                                          X
X                                                          X
X                                                          X
X                                            $             X
X                                                          X
X                                                          X
X                                                          X
X                                                          X
XXXXXXXXXXXXXXXXXXXXXXXXXXXXXXXXXXXXXXXXXXXXXXXXXXXXXXXXXXXX